"filename", "language", "CSS", "comment", "blank", "total"
"c:\xampp-production\htdocs\lmh-perpignan\css\color.css", "CSS", 47, 9, 13, 69
"c:\xampp-production\htdocs\lmh-perpignan\css\components\connexion.css", "CSS", 52, 2, 17, 71
"c:\xampp-production\htdocs\lmh-perpignan\css\components\footer.css", "CSS", 123, 4, 37, 164
"c:\xampp-production\htdocs\lmh-perpignan\css\components\navbar.css", "CSS", 87, 13, 35, 135
"c:\xampp-production\htdocs\lmh-perpignan\css\components\partenaire.css", "CSS", 85, 9, 18, 112
"c:\xampp-production\htdocs\lmh-perpignan\css\components\partenaires.css", "CSS", 35, 5, 9, 49
"c:\xampp-production\htdocs\lmh-perpignan\css\components\reservation.css", "CSS", 249, 13, 69, 331
"c:\xampp-production\htdocs\lmh-perpignan\css\components\slider.css", "CSS", 217, 5, 55, 277
"c:\xampp-production\htdocs\lmh-perpignan\css\components\univers.css", "CSS", 123, 4, 33, 160
"c:\xampp-production\htdocs\lmh-perpignan\css\framework\utiles.css", "CSS", 761, 11, 240, 1012
"c:\xampp-production\htdocs\lmh-perpignan\css\main.css", "CSS", 11, 12, 1, 24
"c:\xampp-production\htdocs\lmh-perpignan\css\style.css", "CSS", 455, 40, 192, 687
"Total", "-", 2245, 127, 719, 3091